#   #	#	#	#	#	#	#	#	#	#	#	#	#	#	#	#	#	#	#	#	#	#	#
#	0	.	.	.	.	.	.	.	.	@	#	#	@	.	.	.	.	.	.	.	@	#	#
#	.	.	.	.	.	.	.	.	.	.	#	#	.	.	.	.	.	.	.	#	#	@	#
#	.	.	#	#	#	#	#	#	#	@	.	.	@	#	#	#	#	#	#	#	#	.	#
#	.	.	#	#	#	#	#	#	@	#	.	.	#	@	#	#	#	#	#	#	.	.	#
#	.	.	#	#	#	#	#	@	#	#	.	.	#	#	@	#	#	#	#	#	.	.	#
#	.	.	#	#	#	@	#	#	#	#	.	.	#	#	#	#	@	#	#	#	.	.	#
#	.	.	#	#	#	#	@	#	#	#	.	.	#	#	#	@	#	#	#	#	.	.	#
#	.	.	#	#	@	#	#	#	#	#	.	.	#	#	#	#	#	@	#	#	.	.	#
#	.	.	#	@	#	#	#	#	#	#	.	.	#	#	#	#	#	#	@	#	.	.	#
#	@	.	@	#	#	#	#	#	#	@	.	#	#	#	#	#	#	#	#	@	.	@	#
#	#	#	.	.	.	.	.	.	.	.	@	#	#	.	.	.	.	.	.	.	#	#	#
#	#	#	.	.	.	.	.	.	.	#	#	@	.	.	.	.	.	.	.	.	#	#	#
#	@	.	@	#	#	#	#	#	#	#	#	.	@	#	#	#	#	#	#	@	.	@	#
#	.	.	#	@	#	#	#	#	#	#	.	.	#	#	#	#	#	#	@	#	.	.	#
#	.	.	#	#	@	#	#	#	#	#	.	.	#	#	#	#	#	@	#	#	.	.	#
#	.	.	#	#	#	#	@	#	#	#	.	.	#	#	#	@	#	#	#	#	.	.	#
#	.	.	#	#	#	@	#	#	#	#	.	.	#	#	#	#	@	#	#	#	.	.	#
#	.	.	#	#	#	#	#	@	#	#	.	.	#	#	@	#	#	#	#	#	.	.	#
#	.	.	#	#	#	#	#	#	@	#	.	.	#	@	#	#	#	#	#	#   .	.   #
#	.	#	#	#	#	#	#	#	#	@	.	.	@	#	#	#	#	#	#	#	.	.	#
#	@	#	#	.	.	.	.	.	.	.	#	#	.	.	.	.	.	.	.	.	.	.	#
#	#	@	.	.	.	.	.	.	.	@	#	#	@	.	.	.	.	.	.	.	.	1	#
#	#	#	#	#	#	#	#	#	#	#	#	#	#	#	#	#	#	#	#	#	#	#	#
