#   #	#	#	#	#	#	#	#	#	#	#	#	#	#	#	#	#	#	#	#	#	#	#
#	0	.	.	.	.	.	.	.	.	.	.	.	.	.	.	.	.	.	.	.	.	.	#
#	.	.	.	.	.	.	.	.	.	.	.	.	.	.	.	.	.	.	.	.	.	.	#
#	.	.	#	#	#	.	.	#	#	#	.	.	#	#	#	.	.	#	#	#	.	.	#
#	.	.	#	#	#	.	.	#	@	#	.	.	#	@	#	.	.	#	@	#	.	.	#
#	.	.	#	#	#	.	.	#	@	#	.	.	#	@	#	.	.	#	@	#	.	.	#
#	.	.	.	.	.	.	.	#	@	#	.	.	#	@	#	.	.	#	@	#	.	.	#
#	.	.	#	#	#	#	.	#	@	#	.	.	#	@	#	.	.	#	@	#	.	.	#
#	.	.	#	#	#	#	.	#	@	#	.	.	#	@	#	.	.	#	@	#	.	.	#
#	.	.	.	@	#	#	.	#	@	#	.	.	#	@	#	.	.	#	@	#	.	.	#
#	.	.	#	#	#	#	.	#	@	#	.	.	#	@	#	.	.	#	@	#	.	.	#
#	.	.	#	#	#	#	.	#	@	#	.	.	#	@	#	.	.	#	@	#	.	.	#
#	.	.	.	.	.	.	.	#	@	#	.	.	#	@	#	.	.	#	@	#	.	.	#
#	.	.	#	#	#	#	#	#	@	#	#	#	#	@	#	#	#	#	@	#	.	.	#
#	.	.	.	@	@	@	@	@	@	@	@	@	@	@	@	@	@	@	@	#	.	.	#
#	.	.	#	#	#	#	#	#	#	#	#	#	#	#	#	#	#	#	#	#	.	.	#
#	.	.	.	.	.	.	.	.	.	.	.	.	.	.	.	.	.	.	.	.	.	.	#
#	.	.	.	.	.	.	.	.	.	.	.	.	.	.	.	.	.	.	.	.	.	.	#
#	.	.	@	@	@	@	@	@	@	@	@	@	@	@	@	@	@	@	@	@	.	.	#
#	.	.	@	@	@	@	@	@	@	@	@	@	@	@	@	@	@	@	@	@   .	.   #
#	.	.	@	@	@	@	@	@	@	@	@	@	@	@	@	@	@	@	@	@	.	.	#
#	.	.	.	.	.	.	.	.	.	.	.	.	.	.	.	.	.	.	.	.	.	.	#
#	.	.	.	.	.	.	.	.	.	.	.	.	.	.	.	.	.	.	.	.	.	1	#
#	#	#	#	#	#	#	#	#	#	#	#	#	#	#	#	#	#	#	#	#	#	#	#
