7 7
0 5 5 5 5 5 #
0 # # # # 5 #
0 # # # # 5 #
0 # # # # 5 #
3 # # # # 5 #
3 # # # # 5 #
3 3 3 3 3 0 0