8 10
0 -5 -5 -5 -5 -5 -5 -5 -5 -5
2 # # # # # # # # -5
2 2 5 5 5 5 5 5 # -5
2 # # # # # # 5 # -5
2 # 5 5 5 5 5 5 # -5
2 # 5 # # # # # # -5
2 2 2 2 2 # 2 2 2 -5
# # # # 2 2 2 # 2 0
